####################
#........##........#
#.##.###.##.###.##.#
#.##.###.##.###.##.#
#..................#
#.##.#.######.#.##.#
#....#...##...#....#
####.###.##.###.####
#..................#
#.##.##.####.##.##.#
#....##.####.##....#
#.##....GGGG....##.#
#.##.##.####.##.##.#
#..................#
####.###.##.###.####
#....#...##...#....#
#.##.#.######.#.##.#
#..................#
#.##.###.##.###.##.#
#.......P..........#
####################